E_X__X_X____XX_X_XX_XXXXX_X__XX_XXX_XX__XXe
X__X_XXX_XX__X___XX______X__XX_XX___X__X___
XX___X___XXX___X__XXXX_XXX_XX__X_XXX_X__XXX
X__X_X_XXX__X__XX__X_X__X__XXX_X___XX_X__X_
X_XX_____X_XXX_X__T_X__X__X__X_X_XX_XX_X_XX
X_XX_X__X_X_X__X___X_XX_XX__X__X_X__X___X_X
X__X__X_XX__X__XX_XX__X__XXX_X__X_X_X_XXXXX
X_XX___XXX_XX___X__XX_X_X__X__XX__XX_X__X__
X___XX__XX______X____X_X_XX__X_X__X__XX__Xe
X__XXX_X__X_XX_XXXX_eX_XXX__X_XX_X_XX__XX__
